R 1500 1500
NO ./textures/wood.png
WE ./textures/colorstone.png
SO ./textures/greystone.png
EA ./textures/mossy.png

S textures/pillar.png

C 0,133,20
F 150,0,0

    11111  111111
    10001  100201
  111000111100001
  111110010000001
11100000000000001
12000000000010001
10000000000000001
10200000000000001
1000000000000N001
10000011111122221
1000001    100001
1000001    100001
1100101    111001
1000001    100001
1111111    111111



